%%%%%%%%%%%%%%%%%%%%%%%%%%%%%%%%%%%%
%                    G             %
% %%%%%%%%%%%%%%%%%%% %%% %%%%%%%% %
% %%   %   %      %%% %%%   %% ... %
% %% % % % % %%%% %%%%%%%%% %% %%%%%
% %% % % % % %    %%     %% %% ... %
% %% % % % % % %%%%  %%%       %%% %
% %  % % %   %    %% %%%%%%%%  ... % 
% %% % % %%%%%%%% %%        %% %%%%%
% %% %   %%            %%%% %% ... %
%    %%%%%% %%%%%%%      %% %%%%%% %
%%%%%%      %       %%%% %% %  ... %
%      %%%%%% %%%%% %P   %% %% %%%%%
% %%%%%%      %       %%%%% %%     %
%        %%%%%% %%%%%%%%%%% %%  %% %
%%%%%%%%%%                  %%%%%% %
%         %%%%%%%%%%%%%%           %	
%%%%%%%%%%%%%%%%%%%%%%%%%%%%%%%%%%%%